TILEMAP
36 28 							-- Size of tile map in tiles
16 32 							-- Tile size & block size
images/blocks.png 	-- Tilesheet
2 2 								-- Number of tiles in tilesheet
111111111111111111111111111111111111
11                                11
11                                11
11                                11
11                                11
11                                11
11                                11
1122   22222           222222   2211
11           222222222            11
11                                11
11                                11
11                                11
1122   2222   22   22   22222   2211
11                                11
11                                11
11              222               11
11                                11
1122   222  22       22  2222   2211
11            2222222             11
11                                11
11                                11
11                                11
1122   2222222222222222222222   2211
11                                11
11                                11
11                                11
11                                11
111111111111111111111111111111111111

